11111111111
10001000001
10C0T000001
10P01000E01
11111111111
