1111111
1P0T001
10CTC01
100T0E1
1111111
