1111111111
1TTTTTTTE1
1TCCCTCCC1
1TCTCTCTT1
1PCTCCCTT1
1111111111
