11111111111111111111111
1P01C000000000011110001
1C0101101C1111001C1E001
10100010010000101001101
10101110110110101001001
1010001001C0001C1001101
1C000111001110010000001
1001C0001000000001100C1
11111111111111111111111
