1111111
100C001
10P1E01
100C001
1110111
