1111111
1PPPPP1
1PECCP1
1PPPPP1
1111111
