1111111
1CCCCC1
1CPCEC1
1CCCCC1
1111111
