1111111111111
10010OIQW00C1
1000011111AS1
1P0011EOIJAS1
1111111111111