1111111
1P001C1
1000011
10000E1
1111111