1111111
100C001
10P1E00
100C001
1111111