1111111
1P001
1C00001
1E001
1111111