1111111
1P01001
10C1C01
10010E1
1111111
