1111111
100C001
00P1E01
100C001
1111111
