1111111
1EEEEE1
1EPCCE1
1EEEEE1
1111111
